......w...................w...................w.............
......w...................w.....w.............w.............
..a...w.........................wwwww.......................
....x.w.....w......................xw.......................
......w.....w.............wwwwwwwwwww.........w.............
......w.....w.............w...................w.............
......w.....w.............w...................w.............
......w.....w.............w...................w.............
......wwwwwww..wwwwwwwwwwwwwwwwwwwwwwwwwwwwwwwwwwwwww..wwwww
......w.....w.............w...................w.............
......w...................w...................w.............
......w...................w...................w.............
......w.....w.............w...................w.............
......w.....w.............w...................w.............
......w.....w.............w...................w.............
......w.....w.............w...................w.............
......w.....w.............w...................w.............
............w.............w...................w.............
............w.............w...................w.............
......w.....w.............w...................w.............
......w.....w.............w...................w.............
......w.....w.............w...................w.............
......w.....w.............w...................w.............
......wwwwwwwwwwwwww......wwwwwww.............wwwwwww..wwwww
......w...................w...................w.............
......w...................w...................w.............
......w...................w...................w.............
......w...................w...................w.............
......w...................w...................w.............
......w...................w...................w.............

w{"type": "TILE", "tileType": "WALL", "passable": false}
.{"type": "TILE", "tileType": "GRASS", "passable": true}
a{"type": "NPC", "message": "They say there's a mad keyboard around here..."}
x{"type": "ITEM", "name": "Awesome keyboard"}
